2/5
1/1/1/11/11/11/11/11/11/1/1/1/1/1/1/1/1/1/1/1
1/320/20/0/0/0/0/0/0/302/302/302/302/302/302/302/302/302/302/1
1/320/20/0/0/0/0/0/0/0/0/0/0/0/0/0/0/0/0/1
1/320/20/0/0/0/0/0/0/0/0/0/0/0/0/0/0/0/0/1
1/320/20/0/0/0/0/0/0/0/0/0/0/0/0/0/0/0/0/1
1/0/0/0/1/0/0/0/0/0/0/0/0/0/0/1/202/0/0/1
1/0/0/0/1/0/40/40/40/40/40/40/40/40/0/1/202/0/0/1
1/0/0/0/1/0/40/40/40/40/40/40/40/40/0/1/202/0/0/1
1/0/0/0/1/0/40/40/40/40/40/40/40/40/0/1/202/0/0/1
1/0/0/0/1/0/40/40/40/40/40/40/40/40/0/1/202/0/0/1
1/0/0/0/1/0/40/40/40/40/40/40/40/40/0/1/202/0/0/1
1/0/0/0/1/0/40/40/40/40/40/40/40/40/0/1/202/0/0/1
1/0/0/0/1/0/0/0/0/0/0/0/0/0/0/1/202/0/0/1
1/0/0/0/1/1/1/1/1/1/1/1/1/1/1/1/202/0/0/1
1/0/0/0/1/302/302/302/302/302/302/302/302/302/302/302/0/0/0/1
1/0/0/0/1/202/0/0/0/0/0/0/0/0/0/0/0/0/0/1
1/0/0/0/1/202/0/0/0/0/0/0/0/0/0/0/0/0/0/1
1/0/0/0/0/0/0/0/0/0/0/0/0/0/0/0/0/0/0/1
1/0/0/0/0/0/0/0/0/0/0/0/0/0/0/0/0/0/0/1
1/11/11/11/11/11/1/1/1/1/1/1/1/1/1/1/1/1/1/1