18/18
1/1/1/1/1/1/1/1/1/1/1/1/1/1/1/1/1/1/1/1/1
1/40/40/40/40/40/40/40/40/40/40/40/322/30/30/30/30/322/30/1
1/40/40/40/40/40/40/40/40/40/40/322/30/30/30/30/30/30/322/11
1/40/40/40/40/40/40/40/40/40/322/30/30/30/30/30/30/30/30/11
1/40/40/40/40/40/40/40/40/322/30/30/30/30/30/30/30/30/30/11
1/30/30/30/30/30/30/30/322/30/30/30/30/30/322/30/30/30/30/11
1/30/30/30/30/30/30/322/30/30/30/30/30/322/30/30/30/30/30/11
1/30/30/30/30/30/322/30/30/30/30/30/322/30/30/30/30/30/30/11
1/30/30/30/30/322/30/30/30/30/30/322/30/30/30/30/30/30/322/1
1/30/30/30/11/30/30/30/30/30/1/30/30/30/30/30/30/322/30/1
11/30/30/30/11/30/30/30/30/30/1/30/30/30/30/30/322/30/30/1
11/30/30/30/11/30/30/30/30/30/1/30/30/30/30/322/30/30/30/1
11/30/30/30/11/30/30/30/30/30/1/30/30/30/322/30/30/30/30/1
11/30/30/30/11/30/30/30/30/30/30/322/30/30/30/322/30/30/30/1
11/30/30/30/30/322/30/30/30/30/30/30/322/30/30/30/322/30/30/1
11/30/30/30/30/30/322/30/30/30/30/30/30/322/30/30/30/322/30/1
11/30/30/30/30/30/30/322/30/30/30/30/30/30/322/30/30/30/322/1
11/30/30/30/30/30/30/30/30/30/30/30/30/30/30/322/30/30/30/1
11/322/322/322/322/30/30/30/30/30/30/30/30/30/30/30/322/30/30/1
1/1/1/1/1/1/1/11/11/11/11/11/11/11/1/1/1/1/1/1