2/2
1/1/1/1/1/1/1/1/1/1/1/1/1/1/1/1/1/1/1/1
1/0/0/0/1/302/302/302/0/0/0/22/0/0/0/0/0/0/0/1
1/0/0/0/1/0/0/0/0/0/0/0/22/0/0/0/0/0/0/1
1/0/0/0/1/0/0/0/0/0/0/0/0/22/0/0/0/0/0/1
1/0/0/0/1/0/0/0/1/0/0/0/0/0/22/0/0/0/0/1
1/0/0/0/1/0/0/0/1/0/0/0/0/0/0/22/0/0/0/1
1/0/0/0/1/0/0/0/1/0/0/0/0/0/0/0/21/0/0/1
1/0/0/0/1/0/0/0/1/0/0/0/0/0/0/0/21/0/0/1
1/220/0/0/32/0/0/0/1/0/0/0/0/0/0/0/21/0/0/1
1/220/0/0/32/0/0/0/1/0/0/0/0/0/0/0/32/0/0/1
1/0/0/0/1/0/0/0/1/0/0/0/0/0/0/0/32/0/0/1
1/0/0/0/1/0/0/0/1/0/0/0/0/0/0/0/32/0/0/1
1/0/0/0/1/0/0/0/1/0/0/0/0/0/0/0/32/0/0/1
1/0/0/0/1/0/0/0/11/0/0/0/0/0/0/0/0/0/0/1
1/0/0/0/1/0/0/0/11/0/0/0/0/0/0/0/0/0/0/1
1/0/0/0/0/0/0/0/11/22/0/0/0/0/40/40/40/40/40/1
1/0/0/0/0/0/0/0/11/22/0/0/0/0/40/40/40/40/40/1
1/0/0/0/0/0/0/0/11/22/0/0/0/0/40/40/40/40/40/1
1/120/120/220/0/0/0/0/11/22/0/0/0/0/40/40/40/40/40/1
1/1/1/1/1/1/1/1/1/1/1/1/1/1/1/1/1/1/1/1