2/18
1/1/1/1/1/1/1/1/1/1/1/1/1/1/1/1/1/1/1/1
1/302/302/302/0/0/0/0/0/0/0/0/0/0/0/0/0/20/20/1
1/0/0/0/0/0/0/0/0/0/0/0/0/0/0/0/0/20/20/1
1/0/0/0/0/0/0/0/0/0/0/0/0/0/0/0/0/0/20/1
1/0/0/20/1/1/1/1/1/1/1/1/1/1/1/1/0/0/0/1
1/0/0/20/1/302/302/302/0/0/0/0/0/0/0/1/0/0/0/1
1/0/0/20/1/0/0/0/0/0/0/0/0/0/0/1/0/0/0/1
1/0/0/0/1/0/0/0/0/0/0/0/0/0/0/1/0/0/0/1
1/0/0/0/1/0/0/0/1/1/1/1/0/0/0/1/0/0/0/1
1/0/0/0/1/0/0/0/1/40/40/40/0/0/0/1/0/0/0/1
1/0/0/0/1/0/0/120/1/40/40/40/0/0/0/1/0/0/0/1
1/0/0/0/1/0/0/120/1/40/40/40/0/0/32/1/0/0/0/1
1/0/0/0/1/0/0/120/1/40/40/40/0/0/32/1/0/0/0/1
1/0/0/0/1/0/0/0/1/40/40/40/0/0/32/1/0/0/0/1
1/0/0/0/1/0/0/0/1/40/40/40/102/102/102/1/0/0/0/1
1/0/0/0/1/0/0/0/1/1/1/1/1/1/1/1/0/0/0/1
1/0/0/0/1/202/0/0/0/0/0/0/0/0/0/0/0/0/0/1
1/0/0/0/1/202/0/0/0/0/0/0/0/0/0/0/0/0/0/1
1/0/0/0/1/202/0/0/0/20/20/20/20/0/0/0/0/0/0/1
1/1/1/1/1/1/1/1/1/1/1/1/1/1/1/1/1/1/1/1