5/15
1/1/1/1/1/1/1/1/1/1/1/1/1/1/1/1/1/1/1/1
11/40/40/11/32/32/0/0/320/0/320/0/0/0/220/0/220/0/02/1
11/40/40/11/32/0/0/0/0/0/0/0/0/0/0/0/0/0/02/1
11/32/0/11/0/0/0/0/0/0/0/0/0/0/0/0/0/0/0/1
11/0/32/11/0/0/32/0/0/0/0/320/0/20/0/0/0/0/0/1
11/32/0/11/0/0/32/1/1/1/1/0/0/1/0/0/0/0/0/1
11/0/32/11/0/0/0/1/22/22/22/22/0/1/0/0/0/0/0/1
11/32/0/11/0/0/0/1/22/22/22/22/0/1/0/0/0/0/0/1
1/0/0/0/0/0/0/1/1/1/1/1/1/1/1/1/30/30/30/1
1/0/0/0/0/0/32/1/22/0/20/220/0/0/0/0/30/30/30/1
1/0/0/0/0/32/32/1/22/0/0/0/0/0/0/0/30/30/30/1
1/0/0/0/32/32/32/1/22/0/0/0/0/0/0/0/30/30/30/1
1/1/1/1/1/1/1/1/1/11/0/0/1/1/1/1/1/1/1/1
1/32/0/0/0/0/0/0/1/11/0/0/0/0/0/21/1/22/22/1
1/32/0/0/0/0/0/0/1/11/0/0/0/0/0/21/1/22/22/1
1/0/0/0/0/0/0/0/1/11/0/0/0/0/0/21/1/0/0/1
1/0/0/0/0/1/1/1/1/11/0/0/0/0/0/21/1/0/0/1
1/32/0/0/0/0/0/30/30/30/30/0/0/0/0/0/0/0/0/1
1/32/0/0/0/0/0/30/30/30/30/0/0/0/0/0/0/120/120/1
1/1/1/1/1/1/1/1/1/1/1/1/1/1/1/1/1/1/1/1